##############################
A  ####### #             #   #
## #    ## # ####### ### # ###
## # ## ## # ####### ### #  ##
##   ##    #      #  ### ## ##
####### ######### # ##      ##
####### ######### # ## #######
##      ##    # # #  # #######
## ####### ## # # ####      ##
## ####### ## # # ######### ##
##         ## # #    #    # ##
### ######### # #### # #### ##
### ## #  ### #  ### # #    ##
# #    # #### ## ### # # ## ##
# ### ## #    ##     # # #  ##
# ### ## # ######### # # # ###
#     ## # #   ###     # #####
##### ## # # ###   #####     #
#####    # #    ## ######### #
#  ####### #### ## ##    ### #
# ##    ## #### ## ## ## ### #
# ## ## ##         ## ##     #
#    ##    ########## ##### ##
# ###########   ##### #   # ##
# #      ##   #   ### # # # ##
# # #### ## ##### ### # #   ##
### #### ## ##        # ######
### #### ##### ########    ###
### ####       ###########   #
###B##########################
